###################################
#A     #         #       #       #
# ### ### ##### ### ### ### ### ##
#   #     #   #     # #     #    #
### ####### ######### ##### ######
#     #       #       #     #    #
# ### # ##### # ##### # ### # ## #
# #   #     # #     # # #   # #  #
# # ####### ####### ### # ### # ##
# #         #     #     #   # #  #
# ####### ### ### ##### ### # # ##
#       #     #     #   #   #    #
### ### ##### ##### ##### #### ###
#   #         #         #      B #
###################################
